Chat - moduł chatu stworzony w jquery zapisuje chat do pliku txt (deprecated)

database 
	DatabaseConnection
		connect - połączenie z bazą danych
		get_name - zwraca nazwę
		insertData - dodanie pojedyńczego wiersza do dowolnej tabeli w bazie danych 
		getRow - zwraca wiersz o id = $id
		getRowByToken - zwraca wiersz gdy token = $token
		closeConnection - zamyka połączenie z bazą danych
		getLastId - zwraca id ostatniego wiersza, który został wstawiony lub zaktualizowany
		insertUser - dodaje użytkownika do bazy danych w tabeli usertable
		getUserByToken - zwraca wszytkie dane o użytkowniku gdy token = $token 
		getUserByLogin - zwraca wszytkie dane o użytkowniku gdy login = $login 
		updateUserToken - zmienia wartość kolumny token dla użytkownika o danym loginie
		getRooms - zwraca dane o pokojach i ich właścicielach
		createRooms - tworzenie nowego pokoju
		selectRoom - zwraca true lub false gdy o zadanym id gdy token sesyjny użytkownika = token właściciela
		getRoom - zwraca dane o pokoju o zadanym id
		deleteRoom - usuwa pokój z bazy danych
		renameRoom - zmienia nazwę wybranego pokoju
		createFile - tworzy informacje o pliku w bazie danych
		removeFile - usuwa informacje o pliku z bazy danych
		getFile - zwraca informacje o wybranym pliku
		getFileByOwner - zwraca informaje o wszytkich plikach użytkownika
		isOwner - true jeśli zalogowany użytkownik jest właścicielem pliku 
		
files
	index.php - zwraca wszystkie pliki użytkownika
	update
		index - aktualizacja pliku/plików na server do folderu uploads
	upload
		index - ładowanie pliku/plików na server do folderu uploads
	delete
		index - usuwanie pliku z servera
	uploads - miejsce przechowywania plików wrzuconych na server
		PdfToHtml - konwertuje pdf i prezentacje multimedialne do html
		
frontendinz
	
login_system
	ldap - pobieranie danych z systemu ldap
	login -  zapis do bazy danych i przekazywanie do frontendu

proxy
	index - przyjmuje jako paramter get "q" url i tworzy proxy 
	config - konfiguracja proxy

rooms
	index - pośredniczy między frontendem, a DatabaseConnection. Wykonuje polecenia frontendu 

SERVER
	Application	
		*Service - zarządzanie obiektami z domeny i korzystanie z zasobów zewnętrznych
			
	Domain
		Client - fasada funkcji bazodanowych dla frontendu 
		Main - klasa uruchomieniowa servera
		Room - fasada funkcji bazodanowych dla frontendu
	Entities
		RoomEntity - struktura danych pokój
		ClientEntity - struktura danych użytkownik 
		ChatHistoryEntity  - struktura danych historia chatu
		UrlHistoryEntity - struktura danych historia stron www
	Infrastructure
		WebSocket  - implementacja servera rozgłaszającego dane za pomocą socketów
		Database - nawiązanie połaczenia z bazą danych
		ConsoleLogger - wyświetlanie komunitatów servera w konsoli
		FileLogger - zapis komunitatów z konsoli do pliku
	ValueObjects
		MessageVO - struktura danych dla wiadomości
		RoomVO - struktura danych dla eventów wysłanych do przeglądarki. (scroll)

WEBRTC 
	audio-admin - pozwala na strumieniowanie swojego głosu do innych użytkowników. Parametr id musi być taki sam jak u odbiorców
	audio-user - pozwala na obieranie swojego głosu od użytkowników. Parametr id musi być taki sam jak u nadającego